R           512 256
NO   textures/redbrick.xpm
EA textures/redbrick.xpm
WE               textures/redbrick.xpm
SO textures/redbrick.xpm
S                           sprites/sprite_2.xpm
C   0,0,255
F      255,255,255

1111111111111111111111111
1000000000110000000000001
1011000001110000002000001
1001000000000000000000001
1111111110110000111000001
1000000000110001111111111
1111011111011100000010001
1111011111011101010010001
1100110101011100000010001
1000200000000000110010001
1000000000000011010010001
11000001011111011110N0111
1111111101011101111010001
1111111111111111111111111
