R 1024 512
NO textures/redbrick.xpm
EA textures/redbrick.xpm
WE textures/redbrick.xpm
SO textures/eagle.xpm
S sprites/sprite_2.xpm
C 255,9,0
F 57,57,255
111111
100101
102001
1100N1
111111
