

F  0,      250   , 0
C 0  ,    0, 255



EA   textures/redbrick.xpm


R  600 400

NO  ./textures/redbrick.xpm


S  textures/sprite_1.xpm

SO   textures/redbrick.xpm



WE  ./textures/wall.xpm

        1111111111111111111111111
        1000000000110000001000001
        1011000001110000002000001
        1001000000000000021200001    111
111111111011000001110000002000001    101
100000000011000001110111111111111    111
11110111111111011100000000001011111
11110111111111011101110011111111101
11000000110101011000000111111111111
12000N0000020000110000001
120000000000000011010100111
11000201110101011111000001111
1111000111110101110111101001
11111111 11111111111111111111
